#################
#XXXXXX/XXXXXXXX#
#X   XBF/X   X X#
#XXX  X X  XXX X#
#X          X  X#
#X   XXXXXX X  X#
#XXX           X#
#X     X    XXXX#
#X   XXX    X  X#
#X     X XX  X X#
#X  X    X  X  X#
#XXXX          X#
#X       XXX   X#
#X  XXXX X X   X#
#XA  X    X    X#
#XXXXXXXXXXXXXXX#
#################