#################
#XXXXXXXXXXXXXXX#
#X    X      XBX#
#X X XXXX XX  F/#
#X X    X  XXXXX#
#X X  X  X     X#
#X    X    XXXXX#
#X  XXXXXXX    X#
#X          X  X#
#XXXXX X XXXX XX#
#X         XX  X#
#X   X X  XX   X#
#XXXXX    XXXXXX#
#X A X  X      X#
#X          X  X#
#XXXXXXXXXXXXXXX#
#################